	Wed. 1/2	Thur. 1/3	Fri. 1/4	
Allen, Phillip	in	out	out	
Arnold, John	in	in	in	
Belden, Tim				
Black, Don	in	in	in	
Calger, Chris	in	in	in	
Davis, Dana	in	in	in	
Duran, Dave	in	?	?	
Grigsby, Mike	in	in	in	
Lagrasta, Fred	in	in	in	
Luce, Laura	in	in	in	
Martin, Tom	in	in	in	
Milnthorp, Rob	out	in	in	
Neal, Scott	in	in	in	
Presto, Kevin	in	out	out	
Redmond, Brian	in	out	out	
Shively, Hunter	in	in	in	
Sturm, Fletch	in	in	in	
Tycholiz, Barry	in	in	in	
Vickers, Frank	out	?	?	
Zufferli, John	in	in	in	


Tammie Schoppe
Enron Americas-Office of the Chair
Assistant to Louise Kitchen
713.853.4220 office 
713.646.8562 fax
713.253.2131 mobile

